#######################
# #   #           # # #
# # # # ####### # # # #
# # # #       # # # # #
# # # ######### # # # #
# # # #       # #   # #
# # # # ##### # ##### #
# #B# #     # # #   # #
# ### ### # # # # # # #
#     #   # # # # # # #
### ####### # # ### # #
#     #     # #   # # #
##### # ##### ### #   #
#   #     #     # # # #
# # ##### ### # # # # #
# #     # #   #   # # #
# ##### # # ### ### # #
# #   # # #   # #   # #
# # # # ##### # # # # #
#   # #       #   # #A#
#######################
